R 1000 500
NO ./path_north
SO ./path_south
WE ./path_west
EA ./path_east

S ./path_sprite.
F 220,100,0
C 255,30,0

1 1 1 1 1 1 1 1 1 1 1 1 1 1
1 1 0 1 1 0 0 0 0 1 1 1 0 1
1 E 0 0 0 0 0 1 0 0 0 0 0 1
1 1 0 0 1 1 1 1 1 1 1 1 1 1
1 1 1 1 1 1 1 1 1 1 1 1 1 1