R 1250 750
NO ./textures/wood.XPM
SO ./textures/eagle.XPM
WE ./textures/mossy.XPM
EA ./textures/greystone.XPM

S ./textures/pillar.XPM
F 119,221,300
C 0,5,200

11111111111111111111111111
100000000000000000000021  
111111111111111111111101  
100000020000000000000001  
11111110111111111111111111
10000000000000000000000001
10000000000000000000000001
10111111111111111111111101
101                    101
101                    101
101                    101
10111111111111111111111101
10000000000000000000000001
10000000000000000000000001
10000000000000111111111111
100000000000001           
100222222222001           
1000N0000000001           
10000000000000011111111111
10000000000000000000000001
10000000000000000000000001
11111111111111111111111111