R 1000 1000
NO ./textures/wood.XPM
SO ./textures/redbrick.XPM
WE ./textures/bluestone.XPM
EA ./textures/greystone.XPM

S ./textures/barrel.XPM
F 0,0,0
C 0,142,200


111111111111111111111111
100000000000000000000001
100000000000000000000001
100000000000001000000001
100000111110000000000001
100000100010000000000001
100000100010000000100001
100000100010000000000001
100000110110000000000001
100000000000000000000001
100020000000010000000001
100000000000000001000001
100000000000000000000001
100000000000000100000001
1000000000000020N0000001
100000000000000000000001
111111111000000000000001
110100001000000000000001
110000101000000000000001
110100001000000000000001
110111111000000000000001
110000000000000000000001
111111111000000000000001
111111111111111111111111