R 1000 1000
NO ./textures/bricksx34.xpm
SO ./textures/bricksx34.xpm
WE ./textures/bricksx34.xpm
EA ./textures/bricksx34.xpm

S ./textures/pillar.XPM
F 119,221,119
C 0,142,200


111111111111111111111111
100000000000000000000001
100000000000000000000001
100000000000001000000001
100000111110000000000001
100000100010000000000001
100000100010000000100001
100000100010000000000001
100000110110000000000001
100000000000000000000001
10002W000000010000000001
100000000000000001000001
100000000000000000000001
100000000000000100000001
100000000000002000000001
100000000000000000000001
111111111000000000000001
110100001000000000000001
110000101000000000000001
110100001000000000000001
110111111000000000000001
110000000000000000000001
111111111000000000000001
111111111111111111111111