R 1250 850
NO ./textures/wood.XPM
SO ./textures/eagle.XPM
WE ./textures/mossy.XPM
EA ./textures/greystone.XPM

S ./textures/pillar.XPM
F 119,228,119
C 40,142,200

11111111111111111111111111111
10000000000000000000000000001
10110000000222202020000000001
100100000002000000000000W0001
10110000000222202020000000001
10000000000000000000000010001
11110111111111000000000010001
11110111111111011101010010001
11000000110101011100000010001
10000000000000001100000000001
10000000000000001101010010001
11000000110101011111011110001
11110111111101011111011110001
11111111111111111111111111111