R 1000 750
NO ./textures/wood.XPM
SO ./textures/eagle.XPM
WE ./textures/mossy.XPM
EA ./textures/greystone.XPM

S ./textures/barrel.XPM
F 119,221,119
C 0,142,200

11111111111111
12001000011121
1N000001000001
12001111111111
11111111111111