R 1250 750
NO ./textures/wood.XPM
SO ./textures/eagle.XPM
WE ./textures/mossy.XPM
EA ./textures/greystone.XPM

S ./textures/pillar.XPM
F 119,221,119
C 0,142,200

        11111111111111111111
        10000000000000000000111111111
        10110000000000000000000000001
        10010000000000000000000000001
        10100000000002202020000000001
        10000000000000000000111111111
1111111110000000000000000000000000001
100000000000000000000000000000000111
100000000000000000000000000011111
1000000000000000000000000001
1000000000000000111001001000111
10000011100000001 10011110001
1111111 100000001 10000000001
        10000000010000000000111111111
        10110000000000000000000000001
        10010000000000000000000000001
        10100000000002202020000000001
        10000000000000000000000000001
1111111110000000000000000000000000001
100000000000000000000000000000000111
100000000000000000000000000011111
1000000000E00000000000000001
1000000000000000111001001000111
10000011100000001 10011110001
1000001 100000001 10000000001
1111111 111111111 11111111111
101
 1



